!@@@@@@@@@@@@#!@@@@@@@@@@@@#
$************$$************$
$*1223*12223*$$*12223*1223*$
$04  4*4   4*$$*4   4*4  40$
$*5226*52226*%^*52226*5226*$
$**************************$
$*1223*13*12222223*13*1223*$
$*5226*44*52231226*44*5226*$
$******44****44****44******$
%@@@@#*45223 44 12264*!@@@@^
     $*41226 56 52234*$     
     $*44          44*$     
     $*44 !@@  @@# 44*$     
!@@@@^*56 $      $ 56*%@@@@#
$f    p  c$      $   *    f$
%@@@@#*13i$      $ 13*!@@@@^
     $*44 %@@@@@@^ 44*$     
     $*44b         44*$     
     $*44 12222223 44*$     
!@@@@^*56 52231226 56*%@@@@#
$************44************$
$*1223*12223*44*12223*1223*$
$*5234*52226*56*52226*4126*$
$0**44         *******44**0$
%@#*44 13*12222223*13*44*!@^
!@^*56 44*52231226*44*56*%@#
$*o    44****44****44******$
$*1222265223*44*1226522223*$
$*5222222226*56*5222222226*$
$**************************$
%@@@@@@@@@@@@@@@@@@@@@@@@@@^
